
             111111        111111        111111       111111
             111111        111111        111111       111111
             111111        111111        111111       111111
             222222        222222        111111       111111
                                                             



        111111             111111   111111             11111
111111        111111           111111         111111     111                  111            111111      111
111111111111111111111111111111111111111111111111111111111111111111111111111111111111111111111111111111111111111111111111
111111111111111111111111111111111111111111111111111111111111111111111111111111111111111111111111111111111111111111111111
111111111111111111111111111111111111111111111111111111111111111111111111111111111111111111111111111111111111111111111111